    1      2      4      8     16     32     61    110    203    327    537    826   1093   1364   1626   1910   2027   2022   1858   1595   1296   1039    714    505    339    221    121     77     31     22      9      3      1  
    1      2      4      8     16     32     63    119    217    364    566    819   1140   1468   1810   2058   2196   2087   1842   1514   1199    860    600    367    247    152     89     62     40     19     15      8      7      5      4  
    1      2      4      8     16     32     61    114    211    367    584    826   1128   1388   1664   1871   2008   1978   1792   1587   1295   1019    765    516    318    193    107     63     43     25     11      3  
    1      2      4      8     16     32     63    116    195    314    480    672    871   1073   1321   1510   1648   1741   1724   1583   1419   1207    993    774    586    445    358    291    205    146     84     59     32     13      5      4      4      1  
    1      2      4      8     16     32     61    119    220    379    576    823   1113   1376   1645   1777   1836   1864   1666   1475   1241   1021    829    633    445    277    197    137     91     62     38     22      8      2      3      1  
    1      2      4      8     16     31     58    107    193    326    537    821   1160   1479   1721   1896   1971   1895   1719   1540   1275   1054    793    570    362    228    129     60     30      9      3      1      1  
    1      2      4      8     16     31     56    103    168    257    421    624    868   1116   1347   1619   1805   1779   1683   1550   1398   1196   1028    805    630    514    355    247    166     92     48     19     16     14      8      5      1  
    1      2      4      8     16     26     47     81    130    208    323    494    734   1025   1304   1554   1770   1896   1894   1779   1618   1404   1133    842    602    437    308    189     96     52     17      5      1  
    1      2      4      8     16     31     59    113    199    339    532    810   1146   1505   1873   2075   2134   2045   1828   1512   1207    876    592    400    286    195     99     61     32     16      3      1  
    1      2      4      8     16     32     59    116    206    332    508    729    971   1237   1515   1767   1973   2092   2065   1822   1478   1109    787    500    281    170     94     61     35     15      6      4      2      2      1  
    1      2      4      8     16     31     62    119    216    368    565    811   1114   1551   1924   2132   2160   2097   1876   1599   1236    858    560    330    186     92     47     20      9      4      2  
    1      2      4      8     16     32     62    111    178    281    425    623    874   1166   1430   1668   1806   1890   1831   1708   1518   1293   1024    744    518    345    202    115     64     33     15      7      3      3  
    1      2      4      8     16     29     57    105    183    313    489    706    983   1279   1458   1600   1656   1711   1672   1651   1521   1313   1041    813    567    344    214    115     71     41     21     11      3      1      1  
    1      2      4      8     16     32     60    106    180    290    462    648    885   1144   1364   1540   1695   1751   1748   1624   1444   1239   1029    823    618    414    297    208    144     97     64     35     16      8      3      1  
    1      2      4      8     16     32     63    116    217    332    500    687    921   1155   1359   1581   1739   1823   1843   1705   1548   1333   1050    767    531    320    189     96     40     18      3      1  
    1      2      4      8     15     28     53     96    176    286    445    672    933   1209   1426   1637   1800   1870   1746   1575   1407   1194    950    755    546    389    248    162    103     75     46     34     27     21     19     18     12      6      4      2  
    1      2      4      8     16     32     64    121    216    370    592    893   1212   1512   1739   1910   1963   1902   1745   1518   1244    926    699    505    327    223    127     71     35     13      6      3      1  
    1      2      4      8     16     32     59    108    188    303    464    706   1004   1338   1668   1936   2044   2047   1854   1682   1371   1130    828    552    320    170     98     45     16      4      1      1  
    1      2      4      8     16     32     59    107    181    322    517    771   1080   1377   1651   1874   2021   2072   1891   1608   1262   1006    728    520    337    202    152    100     58     29      8      2      1      1  
    1      2      4      8     16     31     61    104    180    286    430    630    876   1132   1380   1665   1814   1867   1831   1640   1374   1140    955    733    528    399    305    237    155     96     55     33     17     10      5  
    1      2      4      8     16     32     57    102    175    304    477    724    995   1297   1632   1844   1904   1893   1806   1628   1371   1160    900    618    428    254    145     93     60     38     15      8      3      3      2      1  
    1      2      4      8     16     31     60    108    187    313    459    617    826   1087   1289   1478   1699   1848   1840   1681   1499   1252   1055    810    604    418    327    241    127     63     23     12      5      5      2      1      1      1  
    1      2      4      7     14     27     51     89    140    219    351    516    745   1048   1350   1632   1776   1864   1888   1772   1594   1344   1040    787    574    411    291    196    131     74     39     15      6      2  
    1      2      4      8     16     32     61    114    204    339    505    747   1046   1335   1537   1617   1640   1604   1621   1596   1483   1307   1002    713    534    360    246    151     87     48     26      9      4      1  
    1      2      4      8     16     32     59    105    185    314    508    772   1070   1374   1647   1832   1936   1955   1835   1636   1434   1098    810    525    335    228    131     74     45     21      6      2  
    1      2      4      8     16     31     62    120    214    368    591    868   1175   1450   1613   1771   1857   1808   1649   1456   1291   1109    832    665    448    293    152     71     35     23      8      4      2      3  
    1      2      4      8     16     32     62    116    206    339    510    773   1086   1426   1734   1947   2154   2127   1914   1643   1289   1003    729    434    228    109     61     30     10      5      2  
    1      2      4      8     15     30     58    111    194    316    493    737   1039   1386   1722   1967   2071   2075   1965   1724   1412   1009    696    444    248    138     74     39     14      7      1  
    1      2      4      8     16     32     56    104    183    287    448    647    879   1102   1364   1614   1777   1898   1881   1783   1591   1280    979    750    505    351    218    105     70     31     20      9      2      3  
    1      2      4      8     16     29     55     94    151    248    398    585    839   1135   1435   1707   1828   1903   1871   1687   1520   1188    956    785    568    383    271    164     95     44     22      8  
    1      2      4      8     16     32     63    123    214    359    565    827   1140   1445   1751   1979   2081   2026   1818   1546   1251    946    699    472    295    157     97     49     23      8      3  
    1      2      4      8     16     28     52     95    163    269    411    624    878   1149   1456   1778   2011   2088   1996   1822   1590   1200    872    588    391    262    139     69     24      8      5      1  
    1      2      4      8     15     30     58    111    197    318    513    760   1061   1348   1625   1820   1950   1934   1869   1686   1419   1128    849    569    351    204    100     38     16      8      4      3      1  
    1      2      4      8     16     32     62    116    214    371    602    879   1175   1483   1746   1812   1902   1885   1750   1565   1220    964    750    549    367    239    127     82     42     20      8      4      2      1  
    1      2      4      8     16     32     61    109    176    271    393    555    719    939   1174   1352   1509   1699   1737   1701   1627   1474   1275   1012    768    527    339    217    145     79     40     19     10      7      3  
    1      2      4      8     16     31     59    112    196    308    458    651    879   1107   1365   1582   1744   1845   1848   1746   1557   1308   1069    768    535    327    222    123     71     31     14      7      3      2      1  
    1      2      4      8     16     31     59    111    194    311    471    641    854   1078   1273   1461   1612   1773   1753   1745   1598   1355   1064    815    600    447    336    195    103     55     28      5      1  
    1      2      4      8     16     32     62    115    197    326    516    771   1026   1349   1626   1821   1998   2018   1897   1743   1471   1164    748    490    295    160     89     37     14      4  
    1      2      4      8     16     32     62    113    211    350    552    805   1115   1433   1718   1918   1984   1885   1769   1545   1274   1032    746    522    367    226    146     78     47     18     11      6      2      2  
    1      2      4      8     15     28     53    103    178    297    460    693    956   1251   1548   1828   2008   2003   1866   1628   1387   1132    876    633    425    258    163     90     54     29     14      7      1      1  
    1      2      4      8     16     31     60    114    206    345    551    808   1094   1377   1642   1788   1777   1786   1733   1567   1371   1107    860    625    426    310    177     84     52     30     23     13      8      4  
    1      2      4      8     16     32     63    118    212    328    499    705    967   1240   1475   1650   1726   1780   1746   1674   1496   1272   1013    750    512    324    195    111     42     20     13      4      2  
    1      2      4      8     15     25     50     95    174    282    420    624    839   1060   1290   1551   1737   1840   1874   1804   1620   1364   1101    879    584    367    216    104     43     22      4      1  
    1      2      4      8     16     29     52     96    167    286    462    725   1029   1334   1659   1919   2055   1973   1852   1564   1343   1015    773    560    409    275    169    106     65     30      9      7      6  
    1      2      4      8     16     31     58     97    164    271    447    665    947   1277   1595   1837   1989   2015   1894   1691   1358   1060    806    565    402    262    180    126     90     60     37     26     13      6  
    1      2      4      8     16     32     62    110    178    282    440    624    831   1065   1259   1447   1531   1553   1538   1432   1314   1182   1020    890    767    645    529    398    271    193    137     97     69     44     23      5      1  
    1      2      4      8     16     30     58    112    189    297    446    614    817   1013   1196   1412   1552   1671   1709   1685   1553   1360   1149    852    711    560    390    247    146     94     61     32     11      2  
    1      2      4      8     16     32     60    102    168    295    476    714    976   1266   1518   1754   1916   2017   1967   1824   1458   1193    884    566    364    212    115     51     22     10      7      2  
    1      2      4      8     16     32     62    111    198    324    510    759   1042   1273   1488   1715   1856   1852   1722   1560   1381   1158    899    693    501    354    230    139     65     26     11      4      4  
    1      2      4      8     16     32     59    102    164    254    398    614    884   1223   1529   1767   1958   1991   1937   1798   1507   1206    879    612    400    264    156    101     64     33     17     11      6      2      1  
